0,0,2
1,0,2
2,0,2
3,0,2
4,0,2
1,1,1
1,2,1
1,3,1
1,4,1
1,5,1
1,6,1
1,7,1
